111111111111111111111111
10P00000000C000000000001
100000000000000000000001
1000C0000110000C00000001
100000000000000000000001
1000000C0000111000000001
100000000000111000000001
1C0000000110000C00000E01
111111111111111111111111