11111111111111111111111111111111
1P000000000000000C00000000000001
10000001001110011100111000000111
10000001000010000100001000000001
10000001001110011100001000001111
10000001000010000100001000000011
10000001001110011100001000000111
10000000000000000000000000000001
100000000000000000000000000000E1
11111111111111111111111111111111