111111111111111111111111111
1P0000000001000001000001001
11000000C111000001000001001
1E0000000CC1000001000001001
111111111111111111111111111