111111111111
100001110001
100001100001
1ECPCC000001
111111111111