111111111111
110000001111
110P00001111
1E000C000001
111111111111