111111111111
1P0000000001
11000000C111
1E0000000CC1
111111111111
