111111111111
1P0000000001
110000000011
1E00000000C1
111111111111
