1111111111111
1111111111111
1111111111111
1P00C00E11111
1111111111111
