1111111111111
1ll1lllllllC1
1llll11111ll1
1Pll11Elllll1
1111111111111